# Gboard Dictionary version:1

dollar	$	ja-JP
blubby	(      0    _   0    )	ja-JP
wave	( * ^ *) ãƒã‚·	ja-JP
boobs	( . Y . )	ja-JP
greet	( Â´â—” Ï‰â—”`) ãƒã‚·	ja-JP
greetings	( Â´â—” Ï‰â—”`) ãƒã‚·	ja-JP
ohshit	( Âºï¹ƒÂº )	ja-JP
bubbles	( Ë˜ Â³Ë˜)ãƒÂ°ï¾ŸÂºâï½¡	ja-JP
sadlenny	( Í¡Â° Ê–Ì¯ Í¡Â°)	ja-JP
nice	( Í¡Â° Íœ Â°)	ja-JP
lenny	( Í¡Â° ÍœÊ– Í¡Â°)	ja-JP
this	( Í¡Â° ÍœÊ– Í¡Â°)_/Â¯	ja-JP
glassesoff	( Í¡Â° ÍœÊ– Í¡Â°)ï¾‰âŒâ– -â– 	ja-JP
catlenny	( Í¡Â° á´¥ Í¡Â°)ï»¿	ja-JP
lennygang	( Í¡Â°( Í¡Â° ÍœÊ–( Í¡Â° ÍœÊ– Í¡Â°)Ê– Í¡Â°) Í¡Â°)	ja-JP
lennysir	( à²  ÍœÊ– à²°à³ƒ)	ja-JP
pingpong	( â€¢_â€¢)O*Â¯`Â·.Â¸.Â·Â´Â¯`Â°Q(â€¢_â€¢ )	ja-JP
bribe	( â€¢Í¡Ë˜ _â€¢Í¡Ë˜)ãƒÃ°	ja-JP
crywave	( â•¥ï¹â•¥) ãƒã‚·	ja-JP
crim3s	( âœœï¸µâœœ )	ja-JP
hitting	( ï½€çš¿Â´)ï½¡ï¾/	ja-JP
glitter	(*ãƒ»â€¿ãƒ»)ãƒâŒ’*:ï½¥ï¾Ÿâœ§	ja-JP
dontcare	(- Ê–Ì¯-)	ja-JP
idc	(- Ê–Ì¯-)	ja-JP
eeriemob	(-(-_-(-_(-_(-_-)_-)-_-)_-)_-)-)	ja-JP
bored	(-_-)	ja-JP
magicflip	(/Â¯â—¡ â€¿ â—¡)/Â¯ ~ â”»â”â”»	ja-JP
sob	(;Â´à¼àº¶Ğ”à¼àº¶`)	ja-JP
cat	(= Ğ¤ã‚§Ğ¤=)	ja-JP
rainbowcat	(=^ï½¥ï½ªï½¥^=))ï¾‰å½¡â˜†	ja-JP
tired	(=____=)	ja-JP
zoidberg	(V) (Â°,,,,Â°) (V)	ja-JP
pear	(__>-	ja-JP
gloomy	(_ã‚œ_ã‚œ_)	ja-JP
kappa	(Â¬,â€¿,Â¬)	ja-JP
whoa	(Â°oâ€¢)	ja-JP
gift	(Â´ãƒ»Ï‰ãƒ»)ã£ç”±	ja-JP
present	(Â´ãƒ»Ï‰ãƒ»)ã£ç”±	ja-JP
wat	(Ã’Ğ”Ã“×±)	ja-JP
hello	(Ê˜â€¿Ê˜)â•¯	ja-JP
ohai	(Ê˜â€¿Ê˜)â•¯	ja-JP
bye	(Ê˜â€¿Ê˜)â•¯	ja-JP
fart	(Ë†âº«Ë†à¹‘)<3	ja-JP
blush	(Ëµ Í¡Â° ÍœÊ– Í¡Â°Ëµ)	ja-JP
pleased	(Ë¶â€¾á·„ â»Ì« â€¾á·…Ëµ)	ja-JP
dong	(Ì¿â–€Ì¿â€‰Ì¿Ä¹Ì¯Ì¿Ì¿â–€Ì¿ Ì¿)Ì„	ja-JP
swag	(Ì¿â–€Ì¿â€¿â€‰Ì¿â–€Ì¿ Ì¿)	ja-JP
evillenny	(Í â‰– ÍœÊ–Í â‰–)	ja-JP
claro	(Í¡ Â° ÍœÊ– Í¡ Â°)	ja-JP
goatse	(Ğ·à¹Îµ)	ja-JP
endure	(Ò‚â—¡_â—¡) á•¤	ja-JP
look	(à²¡_à²¡)â˜	ja-JP
tears	(à²¥ï¹à²¥)	ja-JP
lennyfight	(à¸‡ Í Â° ÍŸÊ– Í¡Â°)à¸‡	ja-JP
fight	(à¸‡ â€¢Ì€_â€¢Ì)à¸‡	ja-JP
victory	(à¹‘â€¢Ì€ã…‚â€¢Ì)à¸‡âœ§	ja-JP
surprised	(à¹‘â€¢Ì ãƒ® â€¢Ì€à¹‘)	ja-JP
frown	(áƒ¦Ë˜âŒ£Ë˜áƒ¦)	ja-JP
damnyou	(á•— Í Â° à¨Š Í Â° )á•—	ja-JP
givemeyourmoney	(â€¢-â€¢)âŒ	ja-JP
cool	(â€¢_â€¢) ( â€¢_â€¢)>âŒâ– -â–  (âŒâ– _â– )	ja-JP
csi	(â€¢_â€¢) ( â€¢_â€¢)>âŒâ– -â–  (âŒâ– _â– )	ja-JP
yeah	(â€¢Ì€á´—â€¢Ì)Ùˆ Ì‘Ì‘	ja-JP
yes	(â€¢Ì€á´—â€¢Ì)Ùˆ Ì‘Ì‘	ja-JP
porcupine	(â€¢á´¥â€¢ )Ì`Ì'Ì`Ì'Ìâ»	ja-JP
ass	(â€¿|â€¿)	ja-JP
butt	(â€¿|â€¿)	ja-JP
duh	(â‰§ï¸¿â‰¦)	ja-JP
wtf	(âŠ™ï¼¿âŠ™')	ja-JP
glasses	(âŒ Í¡â–  ÍœÊ– Í¡â– )	ja-JP
nerd	(âŒâŠ™_âŠ™)	ja-JP
dealwithit	(âŒâ– _â– )	ja-JP
dwi	(âŒâ– _â– )	ja-JP
execution	(âŒâ– _â– )ï¸»â•¦â•¤â”€   (â•¥ï¹â•¥)	ja-JP
cry	(â•¥ï¹â•¥)	ja-JP
run	(â•¯Â°â–¡Â°)â•¯	ja-JP
facebook	(â•¯Â°â–¡Â°)â•¯ï¸µ ÊooqÇÉ”ÉÉŸ	ja-JP
friendflip	(â•¯Â°â–¡Â°)â•¯ï¸µ â”»â”â”» ï¸µ â•¯(Â°â–¡Â° â•¯)	ja-JP
rolleyes	(â—”_â—”)	ja-JP
dog	(â—•á´¥â—•Ê‹)	ja-JP
ohyou	(â—à°¥à±ªà°¥)á´–	ja-JP
ou	(â—à°¥à±ªà°¥)á´–	ja-JP
praise	(â˜ Õà¨Š Õ)â˜	ja-JP
gotit	(â˜ï¾Ÿâˆ€ï¾Ÿ)â˜	ja-JP
point	(â˜ï¾Ÿãƒ®ï¾Ÿ)â˜	ja-JP
flower	(âœ¿â— â€¿â— )	ja-JP
flor	(âœ¿â— â€¿â— )	ja-JP
jake	(âá´¥âÊ‹)	ja-JP
whistle	(ã£^Ğ·^)â™ªâ™¬	ja-JP
inlove	(ã£Â´Ï‰`c)â™¡	ja-JP
nom	(ã£Ë†Ú¡Ë†Ï‚)	ja-JP
yummy	(ã£Ë†Ú¡Ë†Ï‚)	ja-JP
delicious	(ã£Ë†Ú¡Ë†Ï‚)	ja-JP
kiss	(ã¥ ï¿£ Â³ï¿£)ã¥	ja-JP
hug	(ã¥ï½¡â—•â€¿â€¿â—•ï½¡)ã¥	ja-JP
hugs	(ã¥ï½¡â—•â€¿â€¿â—•ï½¡)ã¥	ja-JP
lennyflip	(ãƒ Í¡Â° ÍœÊ– Í¡Â°ãƒ)   ï¸µ ( Íœã€‚ Í¡Ê– Íœã€‚)	ja-JP
tableflip	(ãƒ ã‚œĞ”ã‚œ)ãƒ ï¸µ â”»â”â”»	ja-JP
rageflip	(ãƒà² ç›Šà² )ãƒå½¡â”»â”â”»	ja-JP
duckface	(ãƒ»3ãƒ»)	ja-JP
afraid	(ã†† _ ã††)	ja-JP
y u no	(å±®ï¾ŸĞ”ï¾Ÿ)å±® Y U NO	ja-JP
yuno	(å±®ï¾ŸĞ”ï¾Ÿ)å±® Y U NO	ja-JP
orly	(ëˆˆ_ëˆˆ)	ja-JP
depressed	(ï¸¶ï¸¹ï¸¶)	ja-JP
facepalm	(ï¼â€¸áƒš)	ja-JP
cute	(ï½¡â—•â€¿â€¿â—•ï½¡)	ja-JP
excited	(ï¾‰â—•ãƒ®â—•)ï¾‰*:ãƒ»ï¾Ÿâœ§	ja-JP
glitterderp	(ï¾‰â˜‰ãƒ®âš†)ï¾‰ âŒ’*:ï½¥ï¾Ÿâœ§	ja-JP
luv	-`áƒ¦Â´-	ja-JP
plain	._.	ja-JP
highfive	._.)/\(._.	ja-JP
bat	/|\ ^._.^ /|\	ja-JP
blackeye	0__#	ja-JP
fish	<"(((<3	ja-JP
dope	<(^_^)>	ja-JP
squid	<ã‚³:å½¡	ja-JP
ghast	= _ =	ja-JP
shy	=^_^=	ja-JP
nyeh	@^@	ja-JP
lol	L(Â° O Â°L)	ja-JP
punch	O=('-'Q)	ja-JP
yolo	Yáµ’áµ˜ Oá¶°Ë¡Ê¸ Lá¶¤áµ›áµ‰ Oá¶°á¶œáµ‰	ja-JP
zombie	[Â¬Âº-Â°]Â¬	ja-JP
lennybill	[Ì²Ì…$Ì²Ì…(Ì²Ì… Í¡Â° ÍœÊ– Í¡Â°Ì²Ì…)Ì²Ì…$Ì²Ì…]	ja-JP
yay	\( ï¾Ÿãƒ®ï¾Ÿ)/	ja-JP
thanks	\(^-^)/	ja-JP
thankyou	\(^-^)/	ja-JP
ty	\(^-^)/	ja-JP
meep	\(Â°^Â°)/	ja-JP
help	\(Â°Î©Â°)/	ja-JP
surrender	\_(-_-)_/	ja-JP
metal	\m/,(> . <)_\m/	ja-JP
rock	\m/,(> . <)_\m/	ja-JP
lazy	_(:3ã€âˆ )_	ja-JP
coffee	c[_]	ja-JP
cuppa	c[_]	ja-JP
dj	d[-_-]b	ja-JP
sword	o()xxxx[{::::::::::::::::::>	ja-JP
rage	t(à² ç›Šà² t)	ja-JP
mad	t(à² ç›Šà² t)	ja-JP
dead	xâ¸‘x	ja-JP
finn	| (â€¢ â—¡â€¢)|	ja-JP
tiefighter	|=-(Â¤)-=|	ja-JP
nyan	~=[,,_,,]:3	ja-JP
kiahh	~\(â‰§â–½â‰¦)/~	ja-JP
pound	Â£	ja-JP
yen	Â¥	ja-JP
copy	Â©	ja-JP
c	Â©	ja-JP
<<	Â«	ja-JP
smirk	Â¬â€¿Â¬	ja-JP
r	Â®	ja-JP
dunno	Â¯\(Â°_o)/Â¯	ja-JP
lennyshrug	Â¯\_( Í¡Â° ÍœÊ– Í¡Â°)_/Â¯	ja-JP
shrug	Â¯\_(ãƒ„)_/Â¯	ja-JP
>>	Â»	ja-JP
1/4	Â¼	ja-JP
1/2	Â½	ja-JP
whaa	Ã–	ja-JP
really	Ã²_Ã´	ja-JP
creepcute	Æª(Ú“×²)â€Æªâ€‹â€‹	ja-JP
butterfly	Æ¸ÓœÆ·	ja-JP
epsilon	É›	ja-JP
pooh	Ê• â€¢ÌØˆâ€¢Ì€)	ja-JP
bear	Ê•Â·Í¡á´¥Â·Ê”ï»¿	ja-JP
koala	Ê•Â·Í¡á´¥Â·Ê”ï»¿	ja-JP
lovebear	Ê•â™¥á´¥â™¥Ê”	ja-JP
bearhug	Ê•ã£â€¢á´¥â€¢Ê”ã£	ja-JP
bearflip	Ê•ãƒâ€¢á´¥â€¢Ê”ãƒ ï¸µ â”»â”â”»	ja-JP
delta	Î”	ja-JP
sigma	Î£	ja-JP
sum	Î£	ja-JP
omega	Î©	ja-JP
alpha	Î±	ja-JP
beta	Î²	ja-JP
sad	Îµ(Â´ï­ï¸µï­`)Ğ·	ja-JP
suicide	Îµ/ÌµÍ‡Ì¿Ì¿/â€™Ì¿â€™Ì¿ Ì¿(â—¡ï¸µâ—¡)	ja-JP
lambda	Î»	ja-JP
pi	Ï€	ja-JP
tau	Ï„	ja-JP
evil	Ïˆ(ï½€âˆ‡Â´)Ïˆ	ja-JP
creep	Ô…(â‰–â€¿â‰–Ô…)	ja-JP
happy	Ù©( à¹‘â•¹ ê‡´â•¹)Û¶	ja-JP
haha	Ù©(^â€¿^)Û¶	ja-JP
internet	à¬˜(à©­*ËŠáµ•Ë‹)à©­*â€ŠÌ€Ë‹ ÉªÉ´á´›á´‡Ê€É´á´‡á´›	ja-JP
illuminati	à­§(â–²á´—â–²)ãƒ	ja-JP
riot	à­§à¼¼à² ç›Šà² à¼½à­¨	ja-JP
terrorist	à­§à¼¼à² ç›Šà² à¼½ï¸»â•¦â•¤â”€	ja-JP
fuckoff	à­§à¼¼à² ç›Šà² â•­âˆ©â•®à¼½	ja-JP
gtfo	à­§à¼¼à² ç›Šà² â•­âˆ©â•®à¼½	ja-JP
meh	à² _à² 	ja-JP
gentleman	à² _à²°à³ƒ	ja-JP
sir	à² _à²°à³ƒ	ja-JP
monocle	à² _à²°à³ƒ	ja-JP
mistyeyes	à²¡_à²¡	ja-JP
monster	à¼¼ à¼àº¶ à·´ à¼àº¶à¼½	ja-JP
ghost	à¼¼ ã¤ â•¹ â•¹ à¼½ã¤	ja-JP
gimme	à¼¼ ã¤ â—•_â—• à¼½ã¤	ja-JP
hadouken	à¼¼ã¤à² ç›Šà² à¼½ã¤ â”€=â‰¡Î£O))	ja-JP
why	áƒš(`â—‰â—à±ªâ—Ÿâ—‰â€µáƒš)	ja-JP
youkids	áƒšà¼¼>â•­ ÍŸÊ–â•®<à¼½áƒš	ja-JP
ukids	áƒšà¼¼>â•­ ÍŸÊ–â•®<à¼½áƒš	ja-JP
happygarry	á••( á› )á•—	ja-JP
dance	á••(âŒâ– _â– )á•— â™ªâ™¬	ja-JP
duel	á••(â•­à²°â•­ ÍŸÊ–â•®â€¢Ì)âŠƒÂ¤=(â€”â€”â€”â€”-	ja-JP
flexing	á•™(`â–½Â´)á•—	ja-JP
strong	á•™(â‡€â€¸â†¼â€¶)á•—	ja-JP
lennystrong	á•¦( Í¡Â° ÍœÊ– Í¡Â°)á•¤	ja-JP
toogood	á•¦(Ã²á´¥Ã³)á•¥	ja-JP
loud	á•¦(â©¾ï¹â©½)á•¥	ja-JP
noise	á•¦(â©¾ï¹â©½)á•¥	ja-JP
ebola	á´‡Ê™á´ÊŸá´€	ja-JP
emdash	â€“	ja-JP
--	â€“	ja-JP
cross	â€ 	ja-JP
angry	â€¢`_Â´â€¢	ja-JP
awkward	â€¢Í¡Ë˜ã‡â€¢Í¡Ë˜	ja-JP
ellipsis	â€¦	ja-JP
...	â€¦	ja-JP
cheer	â€»\(^o^)/â€»	ja-JP
interrobang	â€½	ja-JP
euro	â‚¬	ja-JP
tm	â„¢	ja-JP
1/3	â…“	ja-JP
2/3	â…”	ja-JP
1/8	â…›	ja-JP
3/8	â…œ	ja-JP
5/8	â…	ja-JP
7/8	â…	ja-JP
left	â†	ja-JP
<-	â†	ja-JP
up	â†‘	ja-JP
right	â†’	ja-JP
->	â†’	ja-JP
no	â†’_â†	ja-JP
down	â†“	ja-JP
sum	âˆ‘	ja-JP
sqrt	âˆš	ja-JP
infinity	âˆ	ja-JP
inf	âˆ	ja-JP
int	âˆ«	ja-JP
because	âˆµ	ja-JP
since	âˆµ	ja-JP
kawaii	â‰§â—¡â‰¦	ja-JP
acid	âŠ‚(â—‰â€¿â—‰)ã¤	ja-JP
wut	âŠ™Ï‰âŠ™	ja-JP
zen	âŠ¹â•°(âŒ£ÊŸâŒ£)â•¯âŠ¹	ja-JP
meditation	âŠ¹â•°(âŒ£ÊŸâŒ£)â•¯âŠ¹	ja-JP
omm	âŠ¹â•°(âŒ£ÊŸâŒ£)â•¯âŠ¹	ja-JP
cmd	âŒ˜	ja-JP
command	âŒ˜	ja-JP
opt	âŒ¥	ja-JP
option	âŒ¥	ja-JP
fly	â”€=â‰¡Î£((( ã¤â—•Ù„Íœâ—•)ã¤	ja-JP
bond	â”Œ( ÍÂ° ÍœÊ–Í¡Â°)=Îµ/ÌµÍ‡Ì¿Ì¿/â€™Ì¿â€™Ì¿ Ì¿	ja-JP
007	â”Œ( ÍÂ° ÍœÊ–Í¡Â°)=Îµ/ÌµÍ‡Ì¿Ì¿/â€™Ì¿â€™Ì¿ Ì¿	ja-JP
needle	â”Œ(â—‰ ÍœÊ–â—‰)ã¤â”£â–‡â–‡â–‡â•â”€â”€	ja-JP
inject	â”Œ(â—‰ ÍœÊ–â—‰)ã¤â”£â–‡â–‡â–‡â•â”€â”€	ja-JP
fuckyou	â”ŒĞŸâ”(à² _à² )	ja-JP
fu	â”ŒĞŸâ”(à² _à² )	ja-JP
iknowright	â”ï½œï½¥à¸´Ï‰ï½¥à¸´#ï½œâ”Œ	ja-JP
ikr	â”ï½œï½¥à¸´Ï‰ï½¥à¸´#ï½œâ”Œ	ja-JP
unflip	â”¬â”€â”€â”¬ ãƒ(Ã²_Ã³ãƒ)	ja-JP
tabledown	â”¬â”€â”¬ï»¿ ãƒ( ã‚œ-ã‚œãƒ)	ja-JP
flipped	â”¬â”€â”¬ï»¿ ï¸µ /(.â–¡. \ï¼‰	ja-JP
heavytable	â”¬â”€â”¬ï»¿ ï¸µ /(.â–¡. \ï¼‰	ja-JP
lennystalker	â”¬â”´â”¬â”´â”¤( Í¡Â° ÍœÊ–â”œâ”¬â”´â”¬â”´	ja-JP
stalker	â”¬â”´â”¬â”´â”¤(ï½¥_â”œâ”¬â”´â”¬â”´	ja-JP
keen	â”¬â”´â”¬â”´â”¤ÆŸÍ†Ù„ÍœÆŸÍ† à¼½ï¾‰	ja-JP
doubletableflip	â”»â”â”» ï¸µãƒ½(`Ğ”Â´)ï¾‰ï¸µ â”»â”â”»	ja-JP
shout	â•š(â€¢âŒ‚â€¢)â•	ja-JP
chubby	â•­(Ê˜Ì†~â—à±ªâ—Ÿ~Ê˜Ì†)â•®	ja-JP
lennywizard	â•°( Í¡Â° ÍœÊ– Í¡Â° )ã¤â”€â”€â˜†*:ãƒ»ï¾Ÿ	ja-JP
triangle	â–²	ja-JP
t	â–²	ja-JP
emptytriangle	â–³	ja-JP
t2	â–³	ja-JP
omg	â—•_â—•	ja-JP
sun	â˜€	ja-JP
cloud	â˜	ja-JP
snowman	â˜ƒ	ja-JP
star	â˜…	ja-JP
emptystar	â˜†	ja-JP
derp	â˜‰ â€¿ âš†	ja-JP
handleft	â˜œ	ja-JP
hl	â˜œ	ja-JP
angel	â˜œ(âŒ’â–½âŒ’)â˜	ja-JP
toldyouso	â˜œ(ê’¡âŒ“ê’¡)	ja-JP
toldyou	â˜œ(ê’¡âŒ“ê’¡)	ja-JP
handright	â˜	ja-JP
hr	â˜	ja-JP
skull	â˜ 	ja-JP
nuclear	â˜¢	ja-JP
radioactive	â˜¢	ja-JP
nukular	â˜¢	ja-JP
hammerandsickle	â˜­	ja-JP
hs	â˜­	ja-JP
yinyang	â˜¯	ja-JP
yy	â˜¯	ja-JP
smiley	â˜ºï¸	ja-JP
spade	â™ 	ja-JP
club	â™£	ja-JP
h	â™¥	ja-JP
heart	â™¥	ja-JP
love	â™¥â€¿â™¥	ja-JP
diamond	â™¦	ja-JP
note	â™«	ja-JP
sing	â™«	ja-JP
flat	â™­	ja-JP
bemolle	â™­	ja-JP
natural	â™®	ja-JP
sharp	â™¯	ja-JP
diesis	â™¯	ja-JP
d1	âš€	ja-JP
d2	âš	ja-JP
d3	âš‚	ja-JP
d4	âšƒ	ja-JP
d5	âš„	ja-JP
d6	âš…	ja-JP
envelope	âœ‰ï¸	ja-JP
letter	âœ‰ï¸	ja-JP
peace	âœŒ(-â€¿-)âœŒ	ja-JP
victory	âœŒ(-â€¿-)âœŒ	ja-JP
check	âœ”	ja-JP
f	âœ¿	ja-JP
rose	âœ¿Ú¿Ú°Û£â€”	ja-JP
bigheart	â¤	ja-JP
arrowhead	â¤œ(â±º Ê–Ì¯â±º)â¤	ja-JP
therefore	â¸«	ja-JP
so	â¸«	ja-JP
smile	ãƒ„	ja-JP
soviettableflip	ãƒâ”¬â”€â”¬ãƒ ï¸µ ( \oÂ°o)\	ja-JP
dab	ãƒ½( â€¢_)á•—	ja-JP
magic	ãƒ½(ï½€Ğ”Â´)âŠƒâ”â˜†ï¾Ÿ. * ï½¥ ï½¡ï¾Ÿ,	ja-JP
do not want	ãƒ½(ï½€Ğ”Â´)ï¾‰	ja-JP
dontwant	ãƒ½(ï½€Ğ”Â´)ï¾‰	ja-JP
clique	ãƒ½à¼¼ àºˆÙ„Íœàºˆà¼¼ â–€Ì¿Ì¿Ä¹Ì¯Ì¿Ì¿â–€Ì¿ Ì¿à¼½ÆŸÍ†Ù„ÍœÆŸÍ† à¼½ï¾‰	ja-JP
gang	ãƒ½à¼¼ àºˆÙ„Íœàºˆà¼¼ â–€Ì¿Ì¿Ä¹Ì¯Ì¿Ì¿â–€Ì¿ Ì¿à¼½ÆŸÍ†Ù„ÍœÆŸÍ† à¼½ï¾‰	ja-JP
squad	ãƒ½à¼¼ àºˆÙ„Íœàºˆà¼¼ â–€Ì¿Ì¿Ä¹Ì¯Ì¿Ì¿â–€Ì¿ Ì¿à¼½ÆŸÍ†Ù„ÍœÆŸÍ† à¼½ï¾‰	ja-JP
saddonger	ãƒ½à¼¼àºˆÊ–Ì¯àºˆà¼½ï¾‰	ja-JP
donger	ãƒ½à¼¼àºˆÙ„Íœàºˆà¼½ï¾‰	ja-JP
5	åŒ	ja-JP
five	åŒ	ja-JP
lumpy	ê’° ê’¡âŒ“ê’¡ê’±	ja-JP
apple	ï£¿	ja-JP
gun	ï¸»â•¦â•¤â”€	ja-JP
mg	ï¸»â•¦â•¤â”€	ja-JP
noclue	ï¼äººâ—• __ â—•äººï¼¼	ja-JP
kyubey	ï¼äººâ—• â€¿â€¿ â—•äººï¼¼	ja-JP
woo	ï¼¼(ï¼¾Oï¼¾)ï¼	ja-JP
doublesharp	ğ„ª	ja-JP
doubleflat	ğ„«	ja-JP

